Need FinalFantasylization addon

To load the soundpack in game: /ffsoundpack steven2016 or /ffsp steven2016
If it doesn't load the first shot, log out and come back.

Also, don't forget to customize your options in the Addons section of the Interface menu in game.


-----------------------------------------
--
--	FinalFantasylization
--
--	   Steven 2016
--
--	     Soundpack
--
-----------------------------------------
*All Copyrights belong to the originals authors*

Video Games:
Arcania Gothic 4
Assassin's Creed 4 - Black Flag
Baldur's Gate
Baldur's Gate 2
Breath of Fire 3
Breath of Fire 4
Chrono Cross
Diablo
Diablo 2
Dragon Age Origins
Dragon Age Inquisition
Dragon's Crown
Dragon Quest VIII
Dissidia Final Fantasy
Elder's Scroll 4 - Oblivion
Elder's Scroll 5 - Skyrim
Final Fantasy Brave Exvius
Final Fantasy 4 Celtic Moon
Final Fantasy Tactics
Final Fantasy 6
Final Fantasy 7
Final Fantasy 7 Crisis Core
Final Fantasy 8
Final Fantasy 9
Final Fantasy 10
Final Fantasy 11
Final Fantasy 11 Rise of the Zilart
Final Fantasy 12
Final Fantasy 13
Final Fantasy 13-2
Final Fantasy 14
Final Fantasy 15
Final Fantasy Type-0
Guild Wars 2
Justice Monsters Five
Kingdom Hearts 1
Kingdom Hearts 2
King of Dragons
Legaia 2 Duel Saga
Legend of Legaia
Legend of Dragoon
Legend of Zelda A Link to the Past
Legend of Zelda Ocarina of Time
Lightning Returns: Final Fantasy 13
Lunar 2 Eternal Blue
Radiata Stories
Rogue Galaxy
Shining Force 2
Star Ocean 4 - The Last Hope
Sword Coast Legends
Tales of Xillia
Tales of Zestiria
The Last Remnant
The Witcher 3
Tomb Raider 2
White Knight Chronicles
World of Warcraft - Cataclysm

Movie/TV:
Final Fantasy 7 Advent Children
Kingsglaive Final Fantasy XV
Lord of the Ring The Fellowship of the Ring
Lord of the Ring The Two Towers
Star Wars 5, 6
Resident Evil

Artists:
Derek Fiechter
Fantôme Déconnecté
Final Fantasy Best Collection 1987-1994
Jeff Van Dyck
Joanie Meden
Vlad Kuryluk


Tracklisting:


-- Capital Cities Events --

Horde:
OrgrimmarSong = Dragon Age Origins - The Deep Roads
SilvermoonCitySong = Arcania Gothic 4 - Silverlake 2
ThunderBluffSong = LRFF13 - Monoculus
UndercitySong = Kingdom Hearts - This is Halloween

Alliance:
DarnassusSong = Final Fantasy Brave Exvius - Tree of Tales
ExodarSong = FF13 - Taejin's Tower
IronforgeSong = Baldur's Gate Main Theme
StormwindCitySong = Final Fantasy 11 - Vanadiel March

Neutral:
ShattrathCitySong = Baldur's Gate 2 - Romance 1
DalaranSong = Final Fantasy 12 - The Skycity of Bhujerba
EbonHoldSong = Guild Wars 2 March of the Legions
Area52Song = Legend of Dragoon - City of Commerce, Lohan
BootyBaySong = Chrono Cross - Optimism
EverlookSong = Legend of Legaia - Title
GadgetzanSong = Legend of Zelda Ocarina of Time - Gerudo Valley
RatchetSong = Final Fantasy 7 - Costa Del Sol

-- Horde Towns Events --
AgmarsHammerSong = Jeff Van Dyck - Barbarian
ApothecaryCampSong = Final Fantasy 4 Celtic Moon - Dancing Calcobrena
BloodhoofVillageSong = Final Fantasy 7 - Cosmo Canyon
BloodvenomPostSong = Final Fantasy Tactics - The Pervert
BrackenwallVillageSong = Breath of Fire 4 - Song of the Plains
BrillSong = Breath of Fire 4 - Darkness
BorgorokOutpostSong = Chrono Cross - Phantom Ship
CampMojacheSong = Final Fantasy 11 - Galka
CampOneqwahSong = Final Fantasy 12 - Jahara, Land of the Garif
CampTaurajoSong = Kingdom Hearts 2 - The Home of Dragons
CampTunkaloSong = Legaia 2 Duel Saga - Shriek of the Earth
CampWinterhoofSong = Radiata Stories - Outsiders
ConquestHoldSong = Star Wars 5 - The Imperial March (Darth Vader's theme)
CrossroadsSong = Legend of Legaia - Rim Elm
FairbreezeVillageSong = Legend of Dragoon - Lloyd's theme
FalconWatchSong = Breath of Fire 3 - Questionable Century
FalconwingSquareSong = Final Fantasy 7 - Anxious Heart
FlameCrestSong = Diablo 2 - New Options Menu
FreewindPostSong = Legend of Zelda Ocarina of Time - Goron City
GaradarSong = Final Fantasy 8 - Seed
GromarshCrashSiteSong = Final Fantasy 8 - Starting Up
GromgolBaseCampSong = Chrono Cross - Dragonrider
HammerfallSong = Final Fantasy 11 - Fury
KargathSong = Kingdom Hearts 2 - The Underworld
KorkronVanguardSong = Kingdom Hearts 2 - Sacred Moon
MokNathalVillageSong = Legaia 2 Duel Saga - God's Fist
NewAgamandSong = Lord of the Ring The Two Towers - Treebeard
RazorHillSong = Final Fantasy 7 - Mako Reactor
RevantuskVillageSong = Final Fantasy 9 - Tantalus theme
SenjinVillageSong = Final Fantasy 7 - Fort Condor
SepulcherSong = Final Fantasy 9 - Sword of Doubt
ShadowmoonVillageSong = Final Fantasy 11 - Shadow Lord
ShadowpreyVillageSong = Final Fantasy 7 - Barret's theme
SplintertreePostSong = Final Fantasy 7 - Turk's theme
StonardSong = Chrono Cross - Hydra's Swamp
StonebreakerHoldSong = Final Fantasy 12 - Theme of the Empire
SunreaversCommandSong = Final Fantasy 10 - People of the North Pole
SunRockRetreatSong = Final Fantasy 7 - Wutai
SwampratPostSong = Kingdom Hearts 2 - Nights of the Cursed
TarrenMillSong = Kingdom Hearts 2 - This is Halloween
TaunkaleVillageSong = Legend of Legaia - Mist
ThrallmarSong = Legend of Legaia - Songi's First Appearance
ThunderlordStrongholdSong = Legend of Dragoon - Hellena Prison
TranquillienSong = Final Fantasy 7 - Sending a Dream into the Universe
ValormokSong = Legend of Dragoon - Imperial City Kazas
VengeanceLandingSong = Final Fantasy 7 - Shinra Corporation
VenomspiteSong = Final Fantasy 11 Rise of the Zilart - Norg
WarsongHoldSong = FF13-2 - Condition Omega
ZabrajinSong = Kingdom Hearts 1 - Deep Jungle
ZoramgarOutpostSong = Breath of Fire 3 - My favorite trick
GhostWalkerPostSong = Final Fantasy 7 - Mining Town

-- Alliance Towns Events --
AeriePeakSong = Final Fantasy 14 - The Twin Faces of Fate (The Theme of Ul'dah)
AllerianStrongholdSong = Breath of Fire 3 - Eden
AmberpineLodgeSong = Breath of Fire 4 - Tototon Toton To
AstranaarSong = Final Fantasy 9 - Dali
AuberdineSong = Final Fantasy 7 - On that Day, 5 years Ago
AzureWatchSong = Legend of Legaia - Cave of Warmth
BloodWatchSong = Final Fantasy 7 - Judgement Day
ChillwindCampSong = Kingdom Hearts 1 - Dearly Beloved
DarkshireSong = Breath of Fire 4 - How Long will the Rain Last
DolanaarSong = Rogue Galaxy - Timeless Town
ExplorersLeagueOutpostSong = Final Fantasy 7 - On our Way
FeathermoonStrongholdSong = Final Fantasy 12 - Eruyt Village
FizzcrankAirstripSong = Final Fantasy 7 - Opressed People
FordragonHoldSong = Kingdom Hearts 1 - End of the World
ForestSongSong = Radiata Stories - Sending Feelings over the Distance
FortWildervarSong = Legend of Legaia - Lively Imperial Palace
FrostholdSong = Legend of Legaia - Light of the Town
GoldshireSong = Kingdoms Hearts - Traverse Town
HonorHoldSong = Breath of Fire 4 - The World Beneath your Feet
KharanosSong = Breath of Fire 4 - Airily
LakeshireSong = Chrono Cross - Home Arni
MenethilHarborSong = Assassin Creed 4 Black Flag - The Islands of the West Indies
MorgansVigilSong = Final Fantasy 7 Crisis Core - Dreams and Honor
NethergardeKeepSong = Diablo - Town
NijelsPointSong = Final Fantasy 7 - Mark of a Traitor
OreborHarborageSong = Final Fantasy 12 - Rabanastre Lowtown
RebelCampSong = Kingdom Hearts 2 - Sora
RefugePointeSong = Legaia 2 Duel Saga - Everyday Tranquility
SentinelHillSong = Breath of Fire 3 - Country Living
SouthshoreSong = Lord of the Ring The Fellowship of the Ring - Concerning Hobbits
StarsRestSong = Lord of the Ring The Two Towers - Evenstar
StonetalonPeakSong = Final Fantasy 11 Rise of the Zilart - Sanctuary
SylvanaarSong = Final Fantasy 9 - Bran Bal
TalrendisPointSong = Final Fantasy 8 - My mind
TalonbranchGladeSong = Legaia 2 Duel Saga Tanza
TelaarSong = Lunar 2 - Promenade
TelredorSong = Final Fantasy 9 - Kingdom of Burmecia
TempleOfTelhamatSong = Legend of Dragoon - Hokes Village
ThalanaarSong = Final Fantasy 7 - Descendant of Shinobi
ThelsamarSong = Breath of Fire 3 - These Little Things
TheramoreIsleSong = Final Fantasy 7 - Rufus's Welcoming Ceremony
ToshleysStationSong = Final Fantasy 7 - Wall Market
ValianceKeepSong = Final Fantasy 8 - Balamb Garden
ValgardeSong = Kingdom Hearts 1 - Under the Sea
WestfallBrigadeEncampmentSong = Breath of Fire 4 - Brave Heart
WestguardKeepSong = Legend of Dragoon - Royal Castle
WildhammerStrongholdSong = Final Fantasy 7 Crisis Core - A Closed off Village
WindrunnersOverlookSong = Joanie Meden - Woman of Ireland
BrewnallVillageSong = Final Fantasy Best Collection 1987-1994 - Final Fantasy 5 Dear Friends - Legend of the Great Forest
EastvaleLoggingCampSong = Legend of Dragoon - Grassy Plains
PyrewoodVillageSong = WoW Cataclysm - Curse of the Worgen
RuttheranVillageSong = Dissidia Final Fantasy - Main Theme (FF1)
BaelModanSong = Breath of Fire 3 - Life's a Beach
StarfallVillageSong = Legend of Dragoon - Whispering of the Trees
MaclureVineyardsSong = Baldur's Gate - Exploring the Plains
HillsbradFieldsSong = Final Fantasy 7 - Farm Boy

-- Neutral Towns Events --
AltarOfShatarSong = Final Fantasy 7 - One Winged Angel
AmberLedgeSong = Final Fantasy 4 Celtic Moon - Mystic Mysidia
ArgentTournamentGroundsSong = Legaia 2 Duel Saga - Barracks
ArgentVanguardSong = Lord of the Ring The Two Towers - The Hornburg
BouldercragsRefugeSong = Breath of Fire 4 - Tiny Village in the Desert
CenarionHoldSong = Breath of Fire 3 - Guild
CenarionRefugeSong = Legend of Dragoon - Uneasy State
CosmowrenchSong = Final Fantasy 8 - Shuffle or Boogie
CrusadersPinnacleSong = Final Fantasy 8 - Fithos Lusec Wecos Vinosec (orchestrated)
DeathsRiseSong = Final Fantasy 7 - Parochial Town
DunNiffelemSong = Breath of Fire 4 - Working Today Too
EbonWatchSong = Final Fantasy 11 - Sometime Somewhere
EmeraldSanctuarySong = Radiata Stories - The White Town of Deception
EvergroveSong = Chrono Cross - Another Guldove
FrenzyheartHillSong = Final Fantasy 11 Rise of the Zilart - Kazham
HalaaSong = Final Fantasy 7 - Stolen Materia
K3Song = Breath of Fire 3 - Steam Locomotion
KamaguaSong = Star Wars 6 - Jabba's Baroque Recital
LightsBreachSong = Breath of Fire 3 - Island
LightsHopeChapelSong = Kingdom Hearts 2 - A day in Agrabah
MarshalsRefugeSong = Kingdom Hearts 2 - A day in the Savanah
MoakiHarborSong = Legend of Zelda Ocarina of Time - Zora's Domain
MudsprocketSong = Breath of Fire 4 - Watch your Step
NesingwaryBaseCampSong = Legaia 2 Duel Saga - Pirate's Pride
NighthavenSong =  Chrono Cross - Home Termina
RainspeakerCanopySong = Breath of Fire 4 - Pabu-Pabu Puka-Puka
RiversHeartSong = Chrono Cross - Another Termina
SanctumOfTheStarsSong = Final Fantasy 7 - It's hard to stand on both feet
ShadowVaultSong = Final Fantasy 7 - Lurking in the Darkness
SporeggarSong = Final Fantasy 4 Celtic Moon - Palom & Polom
StormspireSong = Breath of Fire 4 - Seagull Flies
SunsReachSong = Breath of Fire 3 - Even the sun's happy
ThoriumPointSong = Final Fantasy 11 - Mithra
TransitusShieldSong = Kingdom Hearts 1 - Captain's Hook Pirate Ship
UnupeSong = Legaia 2 Duel Saga - Wasteland of Far Away Places
WyrmrestTempleSong = Legend of Zelda Ocarina of Time - Spirit Temple
ZimTorgaSong = Dragon's Crown - Canaan Temple
TheHarborageSong = The Last Remnant - Breakers on the Shore
ValorsRestSong = The Last Remnant - A Friendly Ear
SteamwheedlePortSong = The Last Remnant - Gateway to the West
MirageRacewaySong = The Last Remnant - Swirlings Sands
AerisLandingSong = Legaia 2 Duel Saga - Lost Forest
MidrealmPostSong = Dissidia Final Fantasy - Main theme (FF2)
ProtectorateWatchPostSong = Dissidia Final Fantasy - Main theme (FF4)
DawnsReachSong = Derek Fiechter - Knights of the Round Table
LightsTrustSong = Final Fantasy 7 - The Flow of Life
GraniteSpringsSong = Final Fantasy 7 - If you open your Heart
VentureBaySong = Final Fantasy 7 - Ahead on our Way
ScalawagPointSong = Legend of Legaia - Earth of Joy
BlackwatchSong = Final Fantasy 7 - Off the Edge of Despair
DoriansOutpostSong = Legend of Dragoon - Jeek's theme
KartaksHoldSong = Final Fantasy 7 - Infiltrating Shinra Building
LakesideLandingSong = Legaia 2 Duel Saga - Status Change
MisthwisperRefugeSong = Legend of Zelda Ocarina of Time - Windmill Hut
SparktouchedHavenSong = Final Fantasy Best Collection 1987-1994 - Aeria the Prophet of Water (FF3 Legend of Eternal Wind)
DubraJinSong = Legaia 2 Duel Saga - Karavaia
OgrilaSong = Final Fantasy 7 - Holding My Thoughts in my Heart
TimbermawHoldSong = The Last Remnant - Into the Depths
DarrowshireSong = Rogue Galaxy - The Lost Gene
KirinVarVillageSong = Final Fantasy 9 - You're Not Alone

-- Eastern Kingdoms Zones Events --
AlteracMountainsSong = Vlad Kuryluk - Barbarian Campaign 10
ArathiHighlandsSong = Legaia 2 Duel Saga - Wind, Tree and Water
BadlandsSong = Legaia 2 Duel Saga - Forgotten Inheritance
BlackrockMountainSong = Legaia 2 Duel Saga - Evil Desires
BlastedLandsSong = Final Fantasy 12 - The Sandsea
BurningSteppesSong = Chrono Cross - Ghost Island
ColdridgeValleySong = Final Fantasy 8 - Salt Flats
DeadwindPassSong = Final Fantasy 8 - Find your Way
DeathknellSong = Legend of Zelda A Link to the Past - Sanctuary Dungeon
DunMoroghSong = Legend of Dragoon - Silver Land
DuskwoodSong = Legend of Legaia - Quiet Destruction
EasternPlaguelandsSong = Legend of Zelda A Link to the Past - Dark World
ElwynnForestSong = Legend of Zelda Ocarina of Time - Kokiri Forest
EversongWoodsSong = Final Fantasy 7 - You can Hear the Cry of the Planet
GhostlandsSong = Breath of Fire 4 - Freefall
HillsbradFoothillsSong = Dragon Quest VIII - Strange World
IsleofQuelDanasSong = Final Fantasy 9 - Crystal World
LochModanSong = Lunar 2 - Field Towards Tomorrow
NorthshireValleySong = Elder's Scroll 4: Oblivion - Watchman's Ease
RedridgeMountainsSong = Chrono Cross - Drowning Valley
SearingGorgeSong = Final Fantasy 7 - Trail of Blood
SilverpineForestSong = Legend of Legaia - Young nobleman of the mist
StranglethornValeSong = Breath of Fire 4 - Echo
SunstriderIsleSong = Final Fantasy 12 - Forgotten Capital
SwampOfSorrowsSong = Jeff Van Dyck - Tension1
TheHinterlandsSong = Final Fantasy 7 - Forested Temple
TirisfalGladesSong = Final Fantasy 11 - Anxiety
WesternPlaguelandsSong = Legaia 2 Duel Saga - End of The World
WestfallSong = Breath of Fire 3 - Casually
WetlandsSong = Diablo 2 - Wild

-- Kalimdor Zones Events --
AmmenValeSong = Breath of Fire 4 - Destruction
AshenvaleSong = Final Fantasy 9 - Awakened Forest
AzsharaSong = Legend of Dragoon - World Map 4
AzuremystIsleSong = Legend of Legaia - Night Requiem
BloodmystIsleSong = Legaia 2 Duel Saga - God of The Evil Ones
CampNaracheSong = Final Fantasy 9 - Crossing those Hills
DarkshoreSong = Final Fantasy 7 - The Nightmare Beginning
DesolaceSong = Final Fantasy 11 - Hopelessness
DurotarSong = Final Fantasy 7 - Desert Wasteland
DustwallowMarshSong = Final Fantasy 12 - The Feywood
FelwoodSong = Chrono Cross - Shadow's End Forest
FeralasSong = Final Fantasy 7 - In Search of the Man in Black 
MoongladeSong = Legaia 2 Duel Saga - Advancing to Far Away Places
MulgoreSong = Legend of Legaia - Barren fields of Mist
ShadowglenSong = Breath of Fire 4 - Landscape
SilithusSong = Chrono Cross - Earth Dragon Island
StonetalonMountainsSong = Final Fantasy 14 - Whisper of the Land
TanarisSong = Diablo 2 - Harem
TeldrassilSong = Baldur's Gate 2 The Druid's Grove
TheBarrensSong = Legend of Zelda Ocarina of Time - Hyrule Field Main Theme
ThousandNeedlesSong = Final Fantasy 7 - Main Theme (world map)
UngoroCraterSong = Vlad Kuryluk - Campaign 5
ValleyOfTrialsSong = Legaia 2 Duel Saga - Training Cave
WinterspringSong = Chrono cross - Garden of the Gods

-- Outland Zones Events --
BladesEdgeMountainsSong = Breath of Fire 3 - Donden
HellfirePeninsulaSong = Dragon Age Origins - Rise of the Darkspawn
NagrandSong = Derek Fiechter - Lost World
NetherstormSong = Tales of Zestiria - Spiritcrest of the Roaring Dragon
ShadowmoonValleySong = Derek Fiechter - Wings of Pegasus
TerokkarForestSong = Guild Wars 2 - Gendarran Fields
ZangarmarshSong = Star Ocean 4 (The Last Hope) - Shattered Dreams

-- Northrend Zones Events --
BoreanTundraSong = Final Fantasy 4 Celtic Moon - Welcome to Our Town
ColdarraSong = Final Fantasy 7 - Great Northen Cave
CrystalsongForestSong = Fantôme Déconnecté - Espace sans casque
DragonblightSong = Final Fantasy 7 - Buried in the Snow
GrizzlyHillsSong = Final Fantasy 4 Celtic Moon - Rydia's theme
HowlingFjordSong = Final Fantasy 4 Celtic Moon - Troian Beauty
IcecrownSong = Final Fantasy 10 - The Deceased Laugh
SholazarBasinSong = Final Fantasy Tactics - Character Creation
StormPeaksSong = Dragon Age Inquisition - Adamant Fortress
WintergraspSong = Battlegrounds
ZulDrakSong = Chrono Cross - Lizard Dance

-- Battlegrounds Events --
BattleGround1 = Dragon Age Origins - The Circle Tower
BattleGround2 = Sword Coast Legends - Avenge the Fallen
BattleGround3 = Final Fantasy 7 Advent Children - Cloud vs Bahamut
BattleGround4 = Kingsglaive Final Fantasy 15 - Apocalypsis Noctis
BattleGround5 = Final Fantasy Type-0 - War: Warrior Worth a Thousand
BattleGround6 = Final Fantasy Brave Exvius - Sacred Ground
BattleGround7 = Sword Coast Legends - Forged in War
BattleGround8 = Final Fantasy 13-2 - The Ruler of Time and Space
BattleGround9 = Elder's Scroll 5: Skyrim - Watch the Skies
BattleGround10 = Final Fantasy 7 - JENOVA

-- Raid Events --
RaidSong =  Final Fantasy 7 - Bombing Mission
Raid2Song = Final Fantasy Type-0 - War: Recapture
Raid3Song = White Knight Chronicles - An Opponent Draws Near
Raid4Song = Final Fantasy 9 - Ambush Attack
Raid5Song = King of Dragons - The Orc Village
Raid6Song = Tales of Xillia - Life or Death
Raid7Song = Kingdom Hearts 1 - Shrouding Dark Cloud
Raid8Song - Dissidia Final Fantasy - Dungeon FF1

-- Normal Mount Events --
Mounted1Song = Legend of Zelda Ocarina of Time - Horse Race
Mounted2Song = Radiata Stories - Scarlet Wind
Mounted3Song = Rogue Galaxy - Factory In production
Mounted4Song = Final Fantasy 7 - Chocobo
Mounted5Song = Derek Fiechter - Jungle Festival
Mounted6Song = Final Fantasy 8 - Chocobo
Mounted7Song = Final Fantasy 13 - Chocobos of Pulse

Escape1Song = Final Fantasy 9 - RUN !
Escape2Song = Final Fantasy 11 - Rise of The Zilart - Belief
Escape3Song = Final Fantasy 8 Retaliation
Escape4Song = Final Fantasy 10 Enemy Attack
Escape5Song = Tomb Raider 2 Incident Behind you
Escape6Song = Shining Force 2 - Boss Attack
Escape7Song = Dragon's Crown - A Decision has to be made
		
-- Flying Mount Events --
FP1Song = Final Fantasy 7 - Steal the Tiny Bronco
FP2Song = Chrono Cross - Time of the Dreamwatch
FP3Song = Kingdom Hearts - Blast Away! Gummi Ship I
FP4Song = Final Fantasy 8 - Ride On
FP5Song = Final Fantasy 9 - Hilda Garde
FP6Song = Final Fantasy 6 - The Serpent Trench
HordeFP1Song = Final Fantasy 6 - Wild West
HordeFP2Song = Final Fantasy 9 - Kuja's theme
HordeFP3Song = Final Fantasy 14 - Pennons Aloft
HordeFP4Song = The Witcher 3 - Hunt or Be Hunted
HordeFP5Song = Dragon's Crown - Mage's Tower
FlyingMountSong = Final Fantasy 7 - Highwind Takes to the Sky
FlyingMount2Song = Shining Force 2 - Battle 2
FlyingMount3Song = Final Fantasy Type-0 - Soar
FlyingMount4Song = Final Fantasy 6 - Terra

-- Dead/Ghost Events --
Dead1Song = Legend of Zelda Ocarina of Time - Temple of Time
Dead2Song = Breath of Fire 4 - Prayer
Dead3Song = Chrono Cross - Death Sea
Dead4Song = Final Fantasy 7 - Who am I
Dead5Song = Tomb Raider 2 Incident Glory of Nature
Dead6Song = Shining Force 2 Sad Theme
Dead7Song = Shining Force 2 Sad Theme 2
DieSong = Legend of Zelda Ocarina of Time - Title theme
Die2Song = Legend of Zelda Ocarina of Time - Deku Tree
Die3Song = Final Fantasy 7 - Great Warrior
Die4Song = Legend of Zelda Ocarina of Time - Zelda's theme
Die5Song = Legend of Zelda Ocarina of Time - Shiek's theme
Die6Song = Legend of Zelda Ocarina of Time - Nocturne of Shadow
Die7Song = Legend of Zelda Ocarina of Time - Requiem of Spirit
Die8Song = Shining Force 2 - Shrine

-- Fighting Events --
LevelUpSong = Final Fantasy 12 - LevelUp
LevelUp2Song = Shining Force 2 - Attack
LevelUp3Song = Legend of Zelda Ocarina of Time - Item Catch
Fanfare = Dissidia Final Fantasy - Victory Fanfare Chaos
Fanfare2 = Dissidia Final Fantasy - Victory Fanfare Cosmos
Fighting1Song = Legend of Legaia - Brand of the Holy Knuckles
Fighting2Song = Legend of Zelda Ocarina of Time - Middle Boss Battle
Fighting3Song = Final Fantasy 15 - Battle Theme (Night & Cave)
Fighting4Song = King of Dragons - Battle on a Mountain Peak
Fighting5Song = Breath of Fire 3 - Fight
Fighting6Song = Final Fantasy 13 - Blinded by Light
Fighting7Song = Chrono Cross - The Brink of Death
Fighting8Song = Final Fantasy 7 Crisis Core - On the Verge of Assault
Fighting9Song = Final Fantasy 8 - Battle
Fighting10Song = Rogue Galaxy - Brave Heart
Fighting11Song = Final Fantasy 9 - Battle
Fighting12Song = Final Fantasy 10 - Fight
Fighting13Song = Lunar 2 - Footsteps of Decisive Battle
Fighting14Song = Dissidia Final Fantasy - Preparations for Battle
Fighting15Song = White Knight Chronicles - Prelude to Battle
Fighting16Song = Final Fantasy 13-2 - Knight of the Goddess
Fighting17Song = Final Fantasy 6 - Battle Theme
Fighting18Song = Baldur's Gate - Attacked by Assassins

BossSong = LRFF13 - Chaos 
Boss2Song = Final Fantasy 7 - Jenova Absolute
Boss3Song = White Knight Chronicles - A Worthy Opponent Draws Near
Boss4Song = Guild Wars 2 - The Charr Triumphant
Boss5Song = Final Fantasy 7 - Boss
Boss6Song = Final Fantasy 8 - Boss
Boss7Song = Final Fantasy 9 - Battle 2
Boss8Song = Dissidia Final Fantasy - Battle (FF1)
Boss9Song = King of Dragons - To the Castle
Boss10Song = Arcania Gothic 4 - Combat 1
Boss11Song = Final Fantasy 6 - The Decisive Battle

-- PvP Events --
HostileSong = Legend of Dragoon - Boss Battle 3
Hostile2Song = Final Fantasy 15 - Enemy Approaching Theme

-- Misc Events --
SwimSong = FF7 - A Secret, Sleeping in the Deep Sea
Swim2Song = Shining Force 2 - Mithril Diggers
Swim3Song = Kingdom Hearts - Under the Sea
DarkSwimSong = Final Fantasy 7 - Who Are You
SleepSong = Arcania Gothic 4 - Tavern
Sleep2Song = Derek Fiechter - The Captain's Inn
Sleep3Song = Final Fantasy 11 - Mog House
Sleep4Song = Justice Monsters Five - A Hero's Day Off
Sleep5Song = Final Fantasy 14 - On Windy Meadows
Sleep6Song = Radiata Stories - Artisan
Sleep7Song = Final Fantasy 8 - Waltz of the Moon
Sleep8Song = Legend of Legaia - Mei
Sleep9Song = Lunar 2 - Village Town
Sleep10Song = Final Fantasy 15 - Camping Theme
Sleep11Song = Elder's Scroll 5 (Skyrim) - Around the Fire
Sleep12Song = Final Fantasy 6 - Johnny C Bad
Sleep13Song = Rogue Galaxy - Swinging
KillSound = Final Fantasy 7 Kill Sound
CombatSound = Final Fantasy 7 Enter Combat Sound
DeeprunTramSong = Resident Evil Main Theme
ScarletMonasterySong = Final Fantasy 11 - Repression Memoro de La Stono
RazorfenSong = Final Fantasy 12 - Abyss
WailingCavernsSong = Final Fantasy 12 - Dark Night (imperial version)
TheDeadminesSong = Final Fantasy 11 - Castle Zvahl
CavernsOfTimeSong = The Last Remnant - Dark Secrets
